starte die navigation zum N	navigation zum N wird gestartet 
starte die navigation zu M	navigation zu M wird gestartet 
starte die navigation zur F	navigation zur F wird gestartet
fahre mich zum N	zielfuehrung zum N wird gestartet
fahre mich zum M	zielfuehrung zum M wird gestartet
fahre mich zur F	zielfuehrung zur F wird gestartet
bringe mich zum N	sie werden zum N navigiert
bringe mich zum M	sie werden zum M navigiert
bringe mich zur F	sie werden zur F navigiert
navigiere mich in das N	du wirst in das N navigiert
navigiere mich in den M	du wirst in den M navigiert 
navigiere mich in die F	du wirst in die F navigiert
navi nach N bitte	das navi wird nach N eingestellt
navi nach M bitte	das navi wird nach M eingestellt
navi nach F bitte	das navi wird nach F eingestellt
wie komme ich zum N	die beste strecke zum N wird angezeigt
wie komme ich zum M	die beste strecke zum M wird angezeigt
wie komme ich zur F	die beste strecke zur F wird angezeigt
ich moechte zum N	okay route zum N wird angezeigt
ich moechte zum M	okay route zum M wird angezeigt
ich moechte zur F	okay route zur F wird angezeigt
fahr mich mal in das N	du wirst in das N gefahren
fahr mich mal in den M	du wirst in den M gefahren
fahr mich mal in die F	du wirst in die F gefahren
bring mich mal zum N	du wirst zum N navigiert
bring mich mal zum M	du wirst zum M navigiert
bring mich mal zur F	du wirst zur F navigiert
ich will jetzt in das N	die route in das N siehst du auf deinem display
ich will jetzt in den M	die route in den M siehst du auf deinem display
ich will jetzt in die F	die route in die F siehst du auf deinem display
ich will zum N	die route zum N siehst du auf deinem display
ich will zum M	die route zum M siehst du auf deinem display
ich will zur F	die route zur F siehst du auf deinem display
bitte in das N	starte zum N
bitte in den M	starte zum M
bitte in die F	starte zur F
bitte sofort in das N	starte sofort zum N
bitte sofort in den M	starte sofort zum M
bitte sofort in die F	starte sofort zur F
wir muessen nach hause	ihr werdet nach hause gebracht
wir muessen nach hause	ihr werdet schleunigst nach hause gebracht
wir muessen schleunigst nach hause	ihr werdet nach hause gebracht
wir muessen schleunigst nach hause	ihr werdet schleunigst nach hause gebracht
